11111
1P111
110C1
1E001
11111
