111111111111111111111111111111111111111
1000010000010000000000010001C00001000C1
101101011111101111111101010111110101111
1P100000100000C100000001010000000100001
111111101111011101111111011111111111101
100000001000000100001000010000000000001
101111111011111111101011110111111111111
100000000010000000000010000000000000001
111101111110111111111111111111111111101
100000001C10000000010000000000010000001
101111101011111111010111110111110111111
1000001000101C0001000001000001C00000001
111110111110111101111111111101111111101
100000000010000101000001000000000000101
101111111111110101011101011111111111101
101000000100000001000100000000001000001
101011110110111111110111101111111011101
101001000010000000000000001000000010111
101101011111111111011111011110111110001
1000010000000000000100000000000000001E1
111111111111111111111111111111111111111
