111111111111
11000000C000
1C0001111100
1P0011E00000
