11111111111111
10000000000011
1C000111110011
1P001E00000111
11111111111111
