1111111111111
11000000C0001
1C00011111001
1P0011E000001
1111111111111
