11111
10PC1
10111
101E1
11111
