11111
100E1
100P1
1EC01
11111
