11111
1C111
11111
1P0E1
1C001
11111
